{
  "name": "十字",
  "template": [
    "###############",
    "#......#......#",
    "#.####.#.####.#",
    "#.............#",
    "#.##.......##.#",
    "###....#....###",
    "#.##.......##.#",
    "#.............#",
    "#.####.#.####.#",
    "#......#......#",
    "###############"
  ],
  "spawns": [[1,1],[13,9],[13,9],[1,9],[13,1]],
  "crate_density": 0.48
}
